11111111111
1E000000001
10100101001
10100100101
10000P000C1
11111111111
