1111111111111111
10000A0000000CE1
110P000101001CA1
1101010001001CC1
100C0000000000C1
1111111111111111