1111111111111111111111
100000000000C00000C001
100000000000C00000C001
100010000000000000C001
100000000000C00000C001
100000000000C00000CCE1
1010010100000101001CA1
1010010101010001001CC1
1P0000000C0000000000C1
1111111111111111111111