1111111111111111111111111111111111
100000000000000C00000C000000000001
100000010000000C00000C000000000001
100010010000000000000C000000000001
100000000000000C00000C000000000001
100000000000000C00000CCEC000000001
1010010100100000101001CAC000010101
1010010010101010001001CCC000010101
1P0000000C00C0000000000C00000000C1
1111111111111111111111111111111111