1111111111
1ECCCCCCC1
1C1C1C1111
1C1C1CCC11
1C1C1CCC11
1C111C1111
1CCC1C1001
1CCC1C1001
1PCCAC1111
1111111111