1111111111
1E00000C01
1010101111
1010100011
1010100011
1011101111
1000101001
1000101001
1P00A01111
1111111111
